1111111111111111111111
10000000000000000000P1
1000G11100001111111111
100000C100100000100001
1111111100G010000000C1
1000000000001111111111
1C000G00000000000000E1
1111111111111111111111