1111111111
1P000C00E1
1111111111
1G00000001
1111111111