11111111111111111111
100000CCC000000000P1
10000000000000000001
10000011111111111111
1000000CC0000C000001
100000000000000000E1
11111111111111111111