1111111111111
100100000C001
10P0011110111
100011E000001
1111111111111