1111111111111
1C1000000C001
10P0011110111
100011E0000C1
1111111111111