11111111111111111111
100000CCC000000000P1
1000000000100C000001
100C0011111111111111
1000000CC0000C0001E1
10C00000000C00010001
11111111111111111111