1111111111111
1001000000C01
10P0011110111
100011E0000C1
1111111111111